100110000100110000110101010111100100
111100100111100100110101010111100100
110101010110101010110101010100110000
110101010100110000110101010111100100
100110000111100100100110000111100100
110101010111100100110101010111100100
100110000111100100100110000111100100
100110000111100100100110000111100100
110101010111100100100110000111100100
100110000111100100100110000111100100
