100110000100110000
111100100111100100
110101010110101010
110101010100110000
100110000111100100
110101010111100100
100110000111100100
110101010111100100
100110000111100100
110101010111100100